pa	Pronoun Hand pointing right + sense waves radical.
papon	like SP `pana` (to emit), rotated 90¬∞ and emitters coming from a box instead of hand to symbolize an opening
pata	eye (‚â° SP `oko`) looking at a document
patun	‚â° SP `awen` (to stay, unmoving)
pawo	pictogram of a dog‚Äôs face
pajan	‚â° SP `soto` (left side)
pan	arrow with a circle through it (arbitrary)
panta	a closed boom gate
pankosi	shield with negation √ó
panli	‚â° SP `kipisi` (to cut, to split, piece)
pansin	‚â° SP `leko` (block, square)
pani	‚â° SP `telo` (water, liquid)
pasan	smiling face, with mouth closed to distinguish from {lijule} (to laugh)
pasu	‚â° SP `powe` (false, lie)
pi	‚â° SP `lon` ([general preposition], during, place, true)
pikante	mouth radical + chili pepper ‚â° SP `namako` variant (spice, spicy, extra, embellishment)
picijo	‚â° SP `noka` (foot, leg)
pice	‚â° SP `monsi` (back, behind)
pilu	trophy
pijen	a twisted strip, symbolizing a change
pintan	a 5-pointed star written in one stroke; a pentagram
pintu	a dot, with a square to frame it
pinko	
peko	a bowing head and torso (This reminded me of the Japanese onomatopoeia „Éö„Ç≥ {peko} for bowing)
pela	‚â° SP `pilin` (feel, feeling, heart)
pelete	SP `sinpin` (face, front side, vertical surface, fa√ßade) without a dot
peman	a pinky-promise, represented in Sutton SignWriting
pen	SP `lawa` (head) with a check mark inside the head, signifying understanding
penpe	color radical, center signifying no hue, slider signifying brightness
pese	SP `awen` (to wait, to stay) with an ellipsis below to signify anticipation (cf. {patun})
pesuwan	SP `olin` (love) flipped, because SP `wile` (want, need) is taken by {titi}
po	ligature of SP `tan ni:` (because of this:), with the arrow pointing  the other way. cf. {pon}, {nenka}
powele	SP `ko` (powder, paste) with dots to signify dust particles
polan	‚â° SP `sinpin` (face, front side, vertical surface, fa√ßade)
polota	SP `len` (clothes, clothed, hidden) with a negation slash through it
poloko	3D isometric drawing of a cube, to distinguish from {pansin} ‚â° SP `leko` (square, block, cube)
pon	ligature of SP `tan ni:` (because of this:), 180¬∞ rotated to invert its meaning. cf. {po}, {nenka}
posa	a stickman striking a pose, with either arm and leg bending a different direction
puka	a weight, shaped like in cartoons
pucon	{lo} radical ‚â° SP `tawa` with a line above and below to signify ‚Äú{lo} along a predefined lane‚Äù
pula	color radical, circle between red and yellow to signify orange hue, slider to the left to signify darkness
pulusi	‚â° SP `akesi` (reptile, amphibian), ‚Äúcorrected‚Äù variant with 2 pairs of legs
pumi	‚â° SP `ma` (land, earth, country)
ta	‚â° SP `te` (start quote), ultimately chosen arbitrarily
tapala	a drawing of a table from its side
tati	a line in the center, with a line on either side cinching it in the middle. cf. {cenci}
takaha	a hand ‚â° SP `luka` rotated to hold a sword, from SP `utala` (fight, battle, aggressive)
takilo	a drawing of a cone, with a round base and a point protruding above
tawawa	a + sign and a circular arrow; evoking a gimbal or a gyroscope
tawe	a head with a few locks of sideswept hair. loosely inspired by SP `linja lawa` (head-strings = hair).
talika	‚â° SP `nasin` (method, way, road).
talili	SP `luka` (hand) + the pointer finger extending
talun	SP `tenpo` (time) with {cina} (small).
tajali	an arrow going from a circle (a stable state) to a right-pointing triangle (‚Äúplay‚Äù symbol).
tajen	heart ‚â° SP `pilin` (heart, emotion, feeling) + anime anger symbol inside
tamaka	a circle with a burst around it symbolizing an explosion
tamin	a scatter plot with a linear regression line through it
tan	an arrow facing a vertical line (ultimately arbitrary)
tason	a rightward arrow split into two harpoons, signifying a predetermined lane
tasuwi	a pen or other writing instrument, with a curved tail behind its tip
tipa	‚â° SP `poki` (container, bag, box)
titan	{lo} + rotated SP `nasin` (path)
titi	crude drawing of two boobs, looks like SP `wile` (to want, to need, desire)
tiku	‚â° SP `moli` (die, dead)
tile	the ‚Äúslow‚Äù audio symbol
tijante	head + sense radical
tiju	Roman numeral for 10 (X)
tinki	three lines, progressively growing, with a crown on the tallest one
te	{ta} + {le} to signify that it marks a verb
tepu	‚â° SP `open` (open, start, begin)
teka	eye ‚â° SP `oko` + sense radical
ten	‚â° SP `tenpo`; clock showing 3:00
tenja	two lines, with the center bulging out. cf. {satilu}
tene	side view of a box with a bow, symbolizing a Christmas present or something
teneme	a stickman pushing against a box, possibly ‚Äútesting‚Äù his own strength, or ‚Äútesting‚Äù the box‚Äôs durability
tope	‚â° SP `pona` (good, simple)
tolu	an isometric drawing of a cylinder
tomiwa	SP `ilo` (tool) with a check mark on its handle
tonko	squinting eyes with a grimacing mouth, signifying wincing in pain
tu	‚â° SP `sina`, pointing up towards the reader
tuko	like SP `seli` (heat, fire) with curved lines to distinguish from {moto}
tula	a winding road, with a map pin (cf. {jan}) on the far side
tun	‚â° SP `pali` (to do, to make, to work)
tuntan	circle with check mark
tusa	color radical, circle in middle to signify no hue, slider in the middle to signify medium brightness
ka	SP `seme` (what, which, who) variant in <a href='https://jackhumbert.github.io/sitelen-sa/'>Jack Humbert‚Äôs <i>sitelen sa</i></a>
kapan	angry eyebrows, puckered lips to signify disgust
kapu	SP `ilo` with an √ó on its handle
katin	double diamond, reference to the double black diamond sign marking the hardest ski slopes and mountain bike paths
kate	{hakiki} with a question mark above, representing assuming something is true, then questioning whether it is
kaki	lightning bolt
kawa	SP `jaki` boxed
kalawa	hand + heart, to signify art as a ‚Äúlabor of love‚Äù or ‚Äúexpression of one‚Äôs feelings‚Äù
kalan	a saluting stickman, from the torso up
kali	down arrow, with the ground underline to represent a side view
kan	‚â° SP `en` (introduces another subject)
kanta	two beamed eighth notes
kanisa	head with three dots above to signify a pause to ruminate
ki	{lo} with a circle under its front foot, to represent the destination
kike	female sign, ‚â° SP `meli` variant
kikolo	mouth radical + goya / bitter melon
kikuwa	‚â° SP `nasa`
kilima	{lo} plus up arrow
kijeta	finger touching {ipuwe} (rock) to signify hardness
kiju	a circle, with a smaller circle to represent its specular highlight, and an arc to represent its shadow
kin	‚â° SP `suno` (sun, day)
kisa	document + mouth
kisowa	a vertical line, with an arrow diagonally running through it
kela	‚â° SP `musi` (fun, entertainment, frivolous, art)
kemika	a triangle flask with some kind of liquid in it
kenca	{ten} with a downward arrow, cf. SP `tenpo ni` (current time, now)
ko	dotted outline of a circle, signifying a metaphysical variant of {sin}
kota	‚â° SP `toki`
koman	{wip} doorway based on emergency sign, with a pair of legs entering ‚â° SP `kama`
konpa	circle with tremor lines to either side
konpute	a computer chip, with legs leading out of all four sides
kontatu	a kusudama üéä (it‚Äôs a Japanese thing)
ikama	‚â° SP `nimi`